Class: constant

EarthM - Return the value of the Earth Mass Package: @constant Description: Return the value of the EarthM Earth mass.

EarthMoonMassRatio - Return the value of Earth/Moon mass ratio Package: @constant Description: Return the value of Earth/Moon mass ratio

EarthR - Return the value of the Earth mean radius. Package: @constant Description: Return the value of the EarthR Earth mean radius.

G - Return the value of the G Package: @constant Description: Return the value of the G

JupiterM - Return the value of the Jupiter Jupiter mass Package: @constant Description: Return the value of the JupiterM Jupiter mass.

JupiterR - Return the value of the Jupiter mean radius. Package: @constant Description: Return the value of the JupiterR Jupiter mean radius.

NA - Avogadro constant Package: @constant Description: Return the value of the NA Avogadro constant/Avogadro number

PlanckLength - Return the value of the Planck Length Package: @constant Description: Return the value of the Planck Length

PlanckMass - Return the value of the Planck Mass Package: @constant Description: Return the value of the Planck Mass

PlanckT - Return the value of the Planck Temperature Package: @constant Description: Return the value of the Planck Temperature

PlanckTime - Return the value of the PlanckTime Package: @constant Description: Return the value of the Planck Time

R - The Molar gas constant Package: @constant Description: Return the value of the R Molar gas constant.

RAD - Return the value of deg in radians Package: @constant Description: Return the value of deg in radians. Civil day.

Rydberg - Return the value of the Rydberg constant Package: @constant Description: Return the value of the Rydberg constant

SunEarthMoonMassRatio - Return the value of Sun/(Earth+Moon) mass ratio Package: @constant Description: Return the value of Sun/(Earth+Moon) mass ratio

SunJupiterMassRatio - Return the value of Sun/Jupiter mass ratio Package: @constant Description: Return the value of Sun/Jupiter mass ratio

SunL - Return the value of the Sun luminosity. Package: @constant Description: Return the value of the SunL Sun luminosity.

SunM - The Sun mass Package: @constant Description: Return the value of the SunM Sun mass.

SunMarsMassRatio - Return the value of Sun/Mars mass ratio Package: @constant Description: Return the value of Sun/Mars mass ratio

SunMercuryMassRatio - Return the value of Sun/Mercury mass ratio Package: @constant Description: Return the value of Sun/Mercury mass ratio

SunNeptuneMassRatio - Return the value of Sun/Neptune mass ratio Package: @constant Description: Return the value of Sun/Neptune mass ratio

SunR - Return the value of the Sun Radius Package: @constant Description: Return the value of the SunR Sun radius.

SunSaturnMassRatio - Return the value of Sun/Saturn mass ratio Package: @constant Description: Return the value of Sun/Saturn mass ratio

SunUranusMassRatio - Return the value of Sun/Uranus mass ratio Package: @constant Description: Return the value of Sun/Uranus mass ratio

SunVenusMassRatio - Return the value of Sun/Venus mass ratio Package: @constant Description: Return the value of Sun/Venus mass ratio

a - The radiation constant Package: @constant Description: Return the value of the a Radiation constant.

a0 - Bohr radius Package: @constant Description: Return the value of the a0 Bohr radius.

all - Return the value of selected constants in a structure array Package: @constant Description: Return the value of selected constants

all_st - Return the values of selected constants in a structure Package: @constant Description: Return the value of selected constants

all_var - Assign selected constants into the workspace Package: @constant Description: Assign into the workspace variables with the constant names and values.

all_var_clear - Clear selected constants from the workspace Package: @constant Description: Use this function in order ro clear the variables assigin into the workspace by the

alpha - Return the value of the alpha Package: @constant Description: Return the value of the alpha

amu - The atomic mass unit constant Package: @constant Description: Return the value of the amu Atomic mass unit (m(12C)/12)

au - Return the value of the au Package: @constant Description: Return the value of the au

c - Return the value of the c Package: @constant Description: Return the value of the c

day - Return the value of the civil day Package: @constant Description: Return the value of the civil day Civil day.

e - Return the value of the e Package: @constant Description: Return the value of the e

eps0 - Return the value of the eps0 constant Package: @constant Description: Return the value of the eps0 constant Vacuum permittivity/permittivity of free space

h - Return the value of the h Package: @constant Description: Return the value of the h

hbar - Return the value of the hbar Package: @constant Description: Return the value of the hbar

k - Return the value of the Gauss gravitational constant Package: @constant Description: Return the value of the k Gauss gravitational constant.

kB - The Boltzman constant Package: @constant Description: Return the value of the KB Boltzmann constant.

ly - Return the value of the Light year Package: @constant Description: Return the value of the ly Light year.

me - The mass of the electron Package: @constant Description: Return the value of the me Electron rest mass

mp - The proton mass Package: @constant Description: Return the value of the mp Proton rest mass

mu0 - Vacuum permeability/magnetic constant Package: @constant Description: Return the value of the mu0 Vacuum permeability/magnetic constant.

pc - Return the value of the Parsec Package: @constant Description: Return the value of the pc Parsec.

re - Classical radius of the electron Package: @constant Description: Return the value of the re Classical electron radius.

sigma - The Stefan-Boltzmann constant Package: @constant Description: Return the value of the sigma Stefan-Boltzmann constant.

sigmaT - Thompson cross-section constant Package: @constant Description: Return the value of the SigmaT Thompson cross-section constant.

